9 20 
####################
#...#..............#
#.#.#.#.##########.#
#.#...#.#..........#
#.#####.############
#..b#.#............#
#.###.############.#
#.....#............#
#######f############